1111111
1001001
1001001
1112111
1001001
1001001
1111111
